NO ./textures/random_tests/wall_n 500 0
SO ./textures/random_tests/wall_s 500 0
WE ./textures/random_tests/wall_w 500 0
EA ./textures/random_tests/wall_e 500 0
DF ./textures/random_tests/door_face 1145 5000
F 100,60,60
C 60,160,255

1111111111111111111
1000000000000010001
10000000N00001 1001
1000000000000010001 
1d10111011100010001111
10101 101 1001 1001
111111111 1111 1111
  1